:reset
:horiz-flip
:fragment
+----------+
|          |
|   .....  |
|   xxxxx  |
|          |
|          |
|          |
|          |
|          |
:alternative
+----------+
|          |
|     m    |
|   xxxxx  |
|          |
|          |
|          |
|          |
|          |
